COINSSHOP : ﻪﮑﺳ ﻩﺎﮕﺷﻭﺮﻓ
FREE : ﻥﺎﮕﯾﺍﺭ
BUYTIPS : ﺎﻤﻨﻫﺍﺭ ﺪﯾﺮﺧ
GETFREE : ﻥﺎﮕﯾﺍﺭ ﺖﻓﺎﯾﺭﺩ
DAILYREWARD : ﻪﻧﺍﺯﻭﺭ ﻩﺰﯾﺎﺟ
DAY : ﺯﻭﺭ
THANKS : !ﻥﻮﻨﻤﻣ
LOADING : …ﯼﺭﺍﺬﮔﺭﺎﺑ ﻝﺎﺣ ﺭﺩ
LUCKYSPIN : ﺲﻧﺎﺷ ﺥﺮﭼ
NOADSLABEL1 : !ﺕﺎﻐﯿﻠﺒﺗ ﻥﻭﺪﺑ ﯼﺯﺎﺑ
NOADSLABEL2 : ﺩﻮﺑ ﺪﻨﻫﺍﻮﺧ ﺱﺮﺘﺳﺩ ﺭﺩ ﺪﯾﺮﺧ ﺯﺍ ﺪﻌﺑ ﻭ ﺪﻨﺘﺴﻫ ﯼﺭﺎﯿﺘﺧﺍ ﻩﺰﯾﺎﺟ ﯼﺎﻫﻮﯾﺪﯾﻭ
BUY : ﺪﯾﺮﺧ
OUTOFLIVES : ﺪﺷ ﻡﺎﻤﺗ ﺎﻫ‌ﻥﺎﺟ
REFILLTHELIVES : ؟ﺎﻫ‌ﻥﺎﺟ ﮊﺭﺎﺷ
OUTOFTIME : ﺪﺷ ﻡﺎﻤﺗ ﻥﺎﻣﺯ
REFILLTHETIME : ؟ﻥﺎﻣﺯ ﮊﺭﺎﺷ
GIFT : ﻪﯾﺪﻫ
LEVELCLEARED : !ﺪﺷ ﺩﺭ ﺖﯿﻘﻓﻮﻣ ﺎﺑ ﻪﻠﺣﺮﻣ
SETTINGS : ﺕﺎﻤﯿﻈﻨﺗ
SHOP : ﻩﺎﮕﺷﻭﺮﻓﯽﺻﻮﺼﺧ ﻢﯾﺮﺣ
PRIVACY : ﺣﺮﯾﻢ ﺧﺼﻮﺻﯽ
QUITTHEGAME : ﯼﺯﺎﺑ ﺯﺍ ﺝﻭﺮﺧ
DOYOUWANTTOQUIT : ؟ﺪﯾﻮﺷ ﺝﺭﺎﺧ ﯼﺯﺎﺑ ﺯﺍ ﺪﯿﻫﺍﻮﺧ‌ﯽﻣ ًﺎﻌﻗﺍﻭ ﺎﯾﺁ
YES : ﻪﻠﺑ
NO : ﺮﯿﺧ
COMINGSOON : .ﺪﯿﺷﺎﺑ ﯼﺪﻌﺑ ﺖﯾﺪﭘﺁ ﺮﻈﺘﻨﻣ>rb< .ﺪﻧﻮﺷ‌ﯽﻣ ﻪﻓﺎﺿﺍ ﯼﺩﻭﺯ‌ﻪﺑ ﺪﯾﺪﺟ ﻞﺣﺍﺮﻣ
WIN : ﯼﺪﺷ ﻩﺪﻧﺮﺑ
NEXTLEVEL : ﺪﻌﺑ ﻪﻠﺣﺮﻣ
SCORE : ﺯﺎﯿﺘﻣﺍ
POINTS : ﺕﺍﺯﺎﯿﺘﻣﺍ
REVIVEWITHNEWSHAPES : ؟ﺪﯾﺪﺟ ﯼﺎﻫ‌ﻞﮑﺷ ﺎﺑ ﯼﺯﺎﺑ ﻪﻣﺍﺩﺍ
WHATCHADS : ﻎﯿﻠﺒﺗ ﯼﺎﺷﺎﻤﺗ
CONTINUE : ﻪﻣﺍﺩﺍ
YOULOSE : …ﯽﺘﺧﺎﺑ
RETRY : ﻩﺭﺎﺑﻭﺩ ﺵﺎﻠﺗ
ALMOST : …ﺩﻮﺑ ﮏﯾﺩﺰﻧ
ARCADEMODE : ﺪﯿﮐﺭﺁ ﺖﻟﺎﺣ
STAGE : ﻪﻠﺣﺮﻣ {stage}
LEVEL : ﻪﻠﺣﺮﻣ {level}
MOSTPOPULAR : ﻦﯾﺮﺗ‌ﺏﻮﺒﺤﻣ
BESTOFFER : ﺩﺎﻬﻨﺸﯿﭘ ﻦﯾﺮﺘﻬﺑ
NOADS : ﺕﺎﻐﯿﻠﺒﺗ ﻑﺬﺣ
FREESPIN : ﻥﺎﮕﯾﺍﺭ ﺶﺧﺮﭼ
SOUNDS : ﺍﺪﺻ
MUSIC : ﯽﻘﯿﺳﻮﻣ
VIBRATION : ﺵﺯﺮﻟ
GAMEOVER : ﯼﺯﺎﺑ ﻥﺎﯾﺎﭘ
YOURSCORE : ﺎﻤﺷ ﺯﺎﯿﺘﻣﺍ
BESTSCORE : ﺯﺎﯿﺘﻣﺍ ﻦﯾﺮﺘﻬﺑ
NEWRECORD : ﺑﻬﺘﺮﯾﻦ ﺍﻣﺘﯿﺎﺯ
EXITGAME : ﯼﺯﺎﺑ ﺯﺍ ﺝﻭﺮﺧ 
ADVENTURE : مﯽﯾﻮﺟﺍﺮﺟﺍ
CLASSIC : ﮏﯿﺳﺎﻠﮐ
TUTORIAL : ﺵﺯﻮﻣﺁ
RESTORE_PURCHASES : ﺎﻫﺪﯾﺮﺧ ﯽﺑﺎﯾﺯﺎﺑ 
EXTRAWORDS :ﻪﻓﺎﺿﺍ ﺕﺎﻤﻠﮐ 
WORDSNOTINTCLUDEDINTHISLEVEL : ﺪﻧﺭﺍﺪﻧ ﺩﻮﺟﻭ ﻪﻠﺣﺮﻣ ﻦﯾﺍ ﺭﺩ ﻪﮐ ﯽﺗﺎﻤﻠﮐ
CLAIM : ﺖﻓﺎﯾﺭﺩ
COINS : ﻪﮑﺳ
GEMS : ﺱﺎﻤﻟﺍ
TAPTOCOLLECT : ﻥﺰﺑ ﻪﺑﺮﺿ ﺖﻓﺎﯾﺭﺩ ﯼﺍﺮﺑ
DAILYREWARDS : ﻪﻧﺍﺯﻭﺭ ﺰﯾﺍﻮﺟ
SPIN : ﺶﺧﺮﭼ
SELECTLANGUAGE : ﻥﺎﺑﺯ ﺏﺎﺨﺘﻧﺍ
AGAIN : ﻩﺭﺎﺑﻭﺩ
UNLOCK : ﺪﯿﻨﮐ ﺍﺪﯿﭘ ﯽﺳﺮﺘﺳﺩ ﺐﻟﺎﺟ ﺕﺎﻋﺎﻠﻃﺍ ﻪﺑ ﺎﺗ ﺪﯿﻨﮐ ﯼﺭﻭﺁ‌ﻊﻤﺟ ﺍﺭ ﺎﻫ‌ﺕﺭﺎﮐ ،ﻥﺩﺮﮐ ﺯﺎﺑ ﯼﺍﺮﺑ
TipBoosterButton : ﺪﯿﻨﮐ ﻩﺩﺎﻔﺘﺳﺍ )tniH( ﺎﻤﻨﻫﺍﺭ ﺯﺍ ﺪﯿﻧﺍﻮﺗ‌ﯽﻣ ،ﺪﯾﺩﺮﮐ ﺮﯿﮔ ﺮﮔﺍ
HammerBoosterButton : ﺪﻨﮐ‌ﯽﻣ ﺭﺎﮑﺷﺁ ﺪﯿﻨﮐ ﺏﺎﺨﺘﻧﺍ ﻪﮐ ﺍﺭ ﯽﻓﺮﺣ ﺮﻫ ﺶﮑﭼ
ExtraWordsButton : ﺪﻧﻮﺷ‌ﯽﻣ ﻩﺩﺍﺩ ﺶﯾﺎﻤﻧ ﺎﺠﻨﯾﺍ ﻪﻓﺎﺿﺍ ﺕﺎﻤﻠﮐ !ﺪﯾﺩﺮﮐ ﺍﺪﯿﭘ ﻪﻓﺎﺿﺍ ﻪﻤﻠﮐ ﮏﯾ ﺎﻤﺷ
GiftButton : ﺪﯿﻨﮐ ﺖﻓﺎﯾﺭﺩ ﺪﻨﻤﺷﺯﺭﺍ ﻩﺰﯾﺎﺟ ﮏﯾ ،ﻢﺟ ﻥﺩﺮﮐ ﺝﺮﺧ ﺎﺑ>rb<>rb<!ﺪﯾﺩﺮﮐ ﺯﺎﺑ ﻪﯾﺪﻫ ﮏﯾ ﺎﻤﺷ
ShuffleButton : ﺪﯿﻨﮐ ﺍﺪﯿﭘ ﺍﺭ ﺕﺎﻤﻠﮐ ﺮﺗ‌ﻊﯾﺮﺳ ﺪﻨﮐ‌ﯽﻣ ﮏﻤﮐ ﺎﻤﺷ ﻪﺑ ﻥﺩﺮﮐ‌ﻁﻮﻠﺨﻣ ﯼ‌ﻪﻤﮐﺩ
RedGem :ﺪﯿﻨﮐ ﺖﻓﺎﯾﺭﺩ ﺰﻣﺮﻗ ﺱﺎﻤﻟﺍ ﮏﯾ }drow{ ﻪﻤﻠﮐ ﻥﺩﺮﮐ ﻞﺻﻭ ﺎﺑ 
GameTutorial : ﺪﯿﺸﮑﺑ ﺖﮐﺮﺣ ﮏﯾ ﺭﺩ ﺍﺭ ﺩﻮﺧ ﺖﺸﮕﻧﺍ ،}drow{ ﻪﻤﻠﮐ ﻦﺘﺧﺎﺳ ﯼﺍﺮﺑ
Home : ﻪﻧﺎﺧ
HARD : ﺖﺨﺳ
TIMETUT : ﺪﯾﻮﺷ ﻩﺪﻧﺮﺑ ﺎﺗ ﺪﯿﻨﮐ ﻞﺣ ﻥﺎﻣﺯ ﻥﺪﺷ ﻡﺎﻤﺗ ﺯﺍ ﻞﺒﻗ ﺍﺭ ﺕﺎﻤﻠﮐ ﯼ‌ﻪﻤﻫ